H0XXXXXXXXXXXXX
X0X00XT000000XX
X0XX0XXEX0XX0XX
X0XX00X0XXXX0XX
X0000XX00X000XX
XXXX000X0X0XXXX
X0000XXX0X000XX
X0XXXX000X0X0XX
X0XXXX0XXX0X0GF
X0000X0XXX0XXXX
XXXX0X0X0000XXX
X0000X000XX000X
X0XXX0XXXXXXX0X
X00000000N0000X
XXXXXXXXXXXXXXX
