H0XXXXXXXXXXXXX
X0X00XX000000XX
X0XX0XX0X0XX0XX
X0XX00X0XXXX0XX
X0000XX00X000XX
XXXX000X0X0XXXX
X0000XXX0X000XX
X0XXXX000X0X0XX
X0XXXX0XXX0X00G
X0000X0XXX0XXXX
XXXX0X0X0000XXX
X0000X000XX000X
X0XXX0XXXXXXX0X
X0000000000000X
XXXXXXXXXXXXXXX